NO ./sprites/path_to_the_north_texture.xpm
SO ./sprites/path_to_the_south_texture.xpm
WE ./sprites/path_to_the_west_texture.xpm
EA ./sprites/path_to_the_east_texture.xpm

F 42,42,42
C 20,20,20


1111111111111111  
11111111111100011
1111111111100100111
111111111000111000111
11111110001111111000111
1111100011111111111000111
1111001111111111111110011
111E0111111111111111110011
1111001111111111111110011
1111100011111111111000111
11111110001111111000111
111111111000111000111
1111111111100100111
111111111111000111
11111111111111111