NO ./sprites/path_to_the_north_texture.xpm
SO ./sprites/path_to_the_south_texture.xpm
WE ./sprites/path_to_the_west_texture.xpm
EA ./sprites/path_to_the_east_texture.xpm

C 20,20,20

F 42,42,42

        1111111111111111111111111
        1000000000110000000000001
        101100R00111000000R000001
        1001000000000000000000001
111111111011000001110000000000001
10000000001100000111011111D11111
11110111111111011100000010001
11110111111111011101010010001
11000000110101011100000010R01
X0000000000000000D000000D0001
10000000000000001101010010001
110R000111010101111101110000111
11110111 11101R1 101111010N01
11111111 1111111 111111111111
