NO ./sprites/path_to_the_north_texture.xpm
SO ./sprites/path_to_the_south_texture.xpm
WE ./sprites/path_to_the_west_texture.xpm
EA ./sprites/path_to_the_east_texture.xpm

F 42,42,42
C 20,20,20

                    11111111
                    10R00001
                11111011101111
11111111111111111100000000R0011
1R000000111111111011110110001111
1111111000011111000000000000R001
    100001111111101111000111111
     11000000D0000010001111
      111111111010R01011111
            101000101N001
            1011101000001
            1000001111111
            1111100001111
                111100001111111111111111111
                   1111000011111111000D00011111    
                      111100000D00001111100D00X
                         1111111111111111111111