NO ./sprites/path_to_the_north_texture.xpm
SO ./sprites/path_to_the_south_texture.xpm
WE ./sprites/path_to_the_west_texture.xpm
EA ./sprites/path_to_the_east_texture.xpm

F 80,40,10
C 30,60,90

              11111
              1R001
         111111011111
         10000000R011
    111111011110000011
    1R0000000001111111
    10111111001
11111010000R001
X000D0011100111
1111101000001
    101011111
    10N00001
    11111111