NO ./sprites/path_to_the_north_texture.xpm
SO ./sprites/path_to_the_south_texture.xpm
WE ./sprites/path_to_the_west_texture.xpm
EA ./sprites/path_to_the_east_texture.xpm

F 30,70,50
C 10,30,20

         111111
         100011
    1111110100111
    100000010001
11111011110100001
10000000000100001
11111011110111111
    100000011
    1111110111111111
         10N00000001
         11111111111