NO ./sprites/path_to_the_north_texture.xpm
SO ./sprites/path_to_the_south_texture.xpm
WE ./sprites/path_to_the_west_texture.xpm
EA ./sprites/path_to_the_east_texture.xpm

F 50,50,80
C 20,20,40

1X11111111111111111
1NR0000000000000001
101D111111111110101
1010000000000010101
1010111111110010101
1010100000010010101
1010101111010010101
1010100001010010101
1010101111010010101
1010100000010010101
1010111111D10010101
1010000000000010101
1011111111111110101
1000000000D00000001
1111111111111111111